22222222222222222222
22222222222222222222
22222000222222222222
22222100222222222222
22222001222222222222
22200101022222222222
22202022022222222222
20002022022222004422
20100100030000004422
22222022202022004422
22222000002222222222
22222222222222222222
22222222222222222222
22222222222222222222
22222222222222222222